11111111111111111111
10000000000000000001
100000P0000000000001
10000000000000000001
10000000000000000001
10000000000000000001
10000000000000000001
10001111111111100001
10000000000000000001
1000000P000000000001
10000000000000000001
10000000000000000001
10000000000000000001
10000000000000000001
11111111111111111111