11111111111111111111
10000000000000000001
100010P0000010000001
10001000000010010001
10001000000010010001
10001000000010010001
10000000000000000001
10001111111111110001
10000000000000000001
10001001P00010000001
10001001000010000001
10001001000010000001
10001001000010111101
10000000000000000001
11111111111111111111