111111111111111111111
100000000010000000001
10010P000000010000001
100100000000010010001
1001000h0010010010001
100100000010010010001
100000000010000000001
110011111111111110011
100000000010000000001
100100100010010000001
10010010001001000h001
100100100000010000001
1001001b0000010111101
100000000010000000001
111111111111111111111